                                                                                           
                                                                                           
                                                                                           
                                                                                           
                                                                                           
                                                                                           
                                                                                           
                                                                                           
                                                                                           
                                                                                           
                                                                                           
                                                                                           
                                                                                           
                                                                                           
                                                                                           
                                                                                           
                                                                                           
                                                                                           
                                                                                           
                                                                                           
                                                                                           
                                                                                           
                                                                                           
                                                                                           
                                                                                           
                                                                                           
                                                                                           
                                                                                           
                                                                                           
                                                                                           
                                                                                           
                                                                                           
                                                                                           
                                                                       %%%                 
                                                                       %%%                 
                                                                      %%%%                 
                                                                     %%%%%                 
                                                                    %%%%%%                 
                                                             %%     %%%%%%                 
                                                             %%%   %%%%%%                  
                                                            %%%%   %%%%%%                  
                                                           %%%%%  %%%%%%%                  
                                                           %%%%   %%%%%%                   
                                                          %%%%%  %%%%%%%                   
                                                          %%%%%  %%%%%%                    
                                                          %%%%%  %%%%%%                    
                                                         %%%%%  %%%%%%                     
                                               %         %%%%%  %%%%%%                     
                                              %%        %%%%%%  %%%%%%                     
                                              %%        %%%%%  %%%%%%                      
                                             %%%        %%%%%  %%%%%%                      
                                             %%%       %%%%%   %%%%%                       
                                            %%%%       %%%%%  %%%%%%                       
                                            %%%     . %%%%%%  %%%%%%                       
                                           %%%%    .. %%%%%   %%%%%                        
                                           %%%%    .. %%%%%   %%%%%                        
                                           %%%%   ... %%%%   %%%%%%                        
                                          %%%%    ...%%%%%   %%%%%                         
                                          %%%%    ...%%%%%   %%%%%                         
                                          %%%%   ... %%%%    %%%%%                         
                                         %%%%    ...%%%%%    %%%%                          
                                         %%%%   ....%%%%%   %%%%%                          
                                         %%%%   ....%%%%%   %%%%%                          
                                        %%%%    ... %%%%    %%%%%                          
                                        %%%%   ....%%%%%    %%%%                           
                                        %%%%   ....%%%%%   %%%%%                           
                                       %%%%    ... %%%%    %%%%%                           
                                       %%%%   .... %%%%    %%%%%                           
                                       %%%%   ....%%%%%    %%%%%                           
                                      %%%%    ... %%%%%    %%%%                            
                                      %%%%   .... %%%%    %%%%%                            
                                      %%%%   .... %%%%    %%%%%                            
                                     %%%%    ... %%%%%    %%%%%                            
                                     %%%%   .... %%%%%    %%%%                             
                                     %%%%   .... %%%%     %%%%                             
                                    %%%%    ...  %%%%     %%%%                             
                                    %%%%   ....  %%%%    %%%%%                             
                                    %%%%   .... %%%%%    %%%%%                             
                                    %%%%   ...  %%%%     %%%%%                             
                                   %%%%   ....  %%%%     %%%%                              
                                   %%%%   ....  %%%%    %%%%%                              
                                   %%%%   ...  %%%%%    %%%%%                              
                                  %%%%   ....  %%%%     %%%%%                              
                                  %%%%   ....  %%%%     %%%%%                              
                                  %%%%   ...  %%%%%     %%%%                               
                                 %%%%   ....  %%%%%    %%%%%                               
                                 %%%%   ....  %%%%     %%%%%                               
                                 %%%%   ...   %%%%     %%%%%                               
                                %%%%   ....  %%%%%     %%%%%                               
                                %%%%   ....  %%%%%    %%%%%                                
                                %%%%   ...   %%%%     %%%%%                                
                               %%%%    ...  %%%%%     %%%%%                                
                               %%%%   ...   %%%%%     %%%%%                                
                               %%%%   ...   %%%%%    %%%%%                                 
                              %%%%    ...  %%%%%     %%%%%                                 
                              %%%%    ..   %%%%%     %%%%%                                 
                              %%%%    ..   %%%%%    %%%%%%                                 
                             %%%%     .   %%%%%     %%%%%                                  
                             %%%%         %%%%%     %%%%%                                  
                             %%%         %%%%%%    %%%%%%                                  
                             %%%         %%%%%     %%%%%%                                  
                             %%          %%%%%    %%%%%%                                   
                             %%         %%%%%%    %%%%%%                                   
                             %          %%%%%     %%%%%%                                   
                                        %%%%%    %%%%%%                                    
                                       %%%%% P   %%%%%%                                    
                                       %%%%%    %%%%%%%                                    
                                       %%%%     %%%%%%                                     
                                       %%%%    %%%%%%%                                     
                                      %%%%     %%%%%%                                      
                                      %%%%     %%%%%%                                      
                                      %%%     %%%%%%                                       
                                      %%%     %%%%%%                                       
                                              %%%%%                                        
                                              %%%%                                         
                                              %%%%                                         
                                              %%%                                          
                                              %%                                           
                                                                                           
                                                                                           
                                                                                           
                                                                                           
                                                                                           
                                                                                           
                                                                                           
                                                                                           
                                                                                           
                                                                                           
                                                                                           
                                                                                           
                                                                                           
                                                                                           
                                                                                           
                                                                                           
                                                                                           
                                                                                           
                                                                                           
                                                                                           
                                                                                           
                                                                                           
                                                                                           
                                                                                           
                                                                                           
                                                                                           
                                                                                           
                                                                                           
                                                                                           
                                                                                           
                                                                                           
                                                                                           
                                                                                           
