%%%%%%              %%%%%%%          
%%%%%%              %%%%%%%          
%%%%%%              %%%%%%%%         
%%%%%%              %%%%%%%%%        
%%%%%%              %%%%%%%%%        
%%%%%%              %%%%%%%%         
%%%%%%              %%%%%%%%         
%%%%%%              %%%%%%%          
%%%%%               %%%%%%%          
%%%%%               %%%%%%%          
%%%%%               %%%%%%%          
%%%%%               %%%%%%%          
%%%%                %%%%%%%          
%%%%                %%%%%%%          
%%%%                %%%%%%%          
%%%                 %%%%%%%          
%%%                 %%%%%%%          
%%%                 %%%%%%%          
%%%                 %%%%%%%          
%%%                 %%%%%%%          
%%                  %%%%%%%          
%%                  %%%%%%%          
%%                  %%%%%%%          
%%                  %%%%%%%          
%%                 %%%%%%%%          
%                  %%%%%%%%         %
%                  %%%%%%%%         %
%                  %%%%%%%%         %
%                 %%%%%%%%%        %%
                  %%%%%%%%%        %%
                  %%%%%%%%%        %%
                 %%%%%%%%%%       %%%
                 %%%%%%%%%%       %%%
                 %%%%%%%%%%       %%%
                %%%%%%%%%%%      %%%%
                %%%%%%%%%%%      %%%%
                %%%%%%%%%%%      %%%%
               %%%%%%%%%%%%     %%%%%
               %%%%%%%%%%%%     %%%%%
               %% %%%%%%%%%     %%%%%
                 %%%%%%%%%%     %%%%%
                 %%%%%%%%%%    %%%%%%
                %%%%%%%%%%%    %%%%%%
               %%%%%%%%%%%%    %%%%%%
               %%%%%%%%%%%%    %%%%%%
               %%%%%%%%%%%%    %%%%%%
               %%%%%%%%%%%%    %%%%%%
                %%% %%%%%%%    %%%%%%
                 %% %%%%%%%    %%%%%%
